XXXXXXXXXXXXXXXXXXXXXXXXXX
XXXXXXXXXXXXXWXXXXXXXXXXXX
XXAXXXXXXXXXXWXXXXXXXXXXXX
XXXXXXXXXXXXXWXXXXXXXXXXXX
XXXXXXXXXXXXWWXXXXXXXXXXXX
XXXXXXXXXXXWWXXXXXXXXXXXXX
XXXXXXXXXXXXXXXXXWXXXXXXXX
XXXXXXXXXXXXXXXXXWXXXXXXXX
XXXXWWWWWWWWWWXXXWXXXXXXXX
XXXXXXXXXXXXXXXXXWXXXXXXXX
XXXXXXXXXXXXXXXXXWXXXXXXXX
XXXXXXXXXXXXXXXXXWXXXXXXXX
XXXXXXXXXXXXXWXXXWXXXXXXXX
XXXXXXXXXXXXXXXXXWXXXXXXXX
XXWWWWWWWWWWWWWWWWXXXXXXXX
XXXXXXXXXXXXXXXXXXXXXXOXXX
XXXXXXXXXXXXXXXXXXXXXXXXXX
